####################
#..................#
#.##............##.#
#.#..............#.#
#..................#
#..................#
#..................#
#..................#
#..................#
#..................#
#..................#
#..................#
#..................#
#..................#
#..................#
#..................#
#.#..............#.#
#.##............##.#
#..................#
####################
